22220000000002222222
22000100000000022220
20000000333300000200
00000333300332220000
03333300000032220100
33000000000032222000
00002000000033222222
00022200000003333222
01022220000000003333
00002200000000000000
00022222200033300000
00000002220003330022
00000000000033330002
20000000000333330000
22000000000000000000
22222222000000333333
22222222203333300000
22222003333002222222
00000333022222222222
00000300222222222222