0000002000
0100000000
0000000000
0000000000
0000010000
0000000000
0000200000
0000000000
0003000000
0000000000