22220000000002222222
22000100000000022220
20000000333300000200
00000333300332220000
03333300000032220100
33000000000032222000
00002000000033222222
00022200000003333222
01022220000000003333
00002200000000000000