2222000000
2200010000
2000000033
0000033330
0333330000
3300000000
0000200000
0002220000
0102222000
0000220000